1111111111111111111111111111111111111111000000000000000000000000
1111111111111111111111111111111111111111000000000000000000000000
1100000000000000000000000000000000000011000000000000000000000000
1100000000000000000000000000000000000011000000000000000000000000
1111114000000000000000000000000000000011000000000000000000000000
1111111111000000000000000111000000000011000000000000000000000000
1111111111110000044000000111000000000011000000000000000000000000
1111111111110001111111000011001110000011000000000000000000000000
1111111100110001111111000000001110000011000000000000000000000000
1111110000000000111100000000000000001111000000000000000000000000
1111110000000000000000000000000000001111000000000000000000000000
1111100000000000000000000000000000800011000000000000000000000000
1100000000000000000000000004000001111111000000000000000000000000
1100000000000000000004000411111111111111000000000000000000000000
1100000000000004440111111111111111111111000000000000000000000000
1108000000001111111111111111111111111111000000000000000000000000
1111111000001111111110000111111111000111000000000000000000000000
1111111110000111110000000000001111000011000000000000000000000000
1100111110000000000000000000000111000011000000000000000000000000
1100000111000000000000000000000110000001000000000000000000000000
1122221111110004000040000000000000000001000000000000000000000000
1122221111111111111111111108000000000001000000000000000000000000
1111111111111111111111111111100000000011000000000000000000000000
1111111100000000000001111111100110000011000000000000000000000000
1110000000000800000000000000000110000111000000000000000000000000
1100000000001111110000000000000000011111000000000000000000000000
1100000000011111110000000000000000011111000000000000000000000000
1108000440111111114400000008040000000011000000000000000000000000
1111111111111111111112222221111111111111000000000000000000000000
1111111111111111111111111111111111111111000000000000000000000000
0000000000000000000000000000000000000000000000000000000000000000
0000000000000000000000000000000000000000000000000000000000000000
